git -> to clone paru
gammastep -> night light 
systemd-zram -> enable zram
firefox -> browser
stow -> dotfile deployment
brightnessctl -> needed for brightness control
xdg-desktop-portal-wlr -> wayland stuff
xdg-desktop-portal-gtk -> stuff that the wayland stuff doesn't implement
xdg-user-dirs -> user direcotries
xorg-xwayland -> non-wayland application support
eza -> cool and fast ls replacement
thunar -> file manager
xsettingsd -> theming for applications using xwayland
grim -> wayland screenshots
slurp -> allows taking coordinates of areas in wayland for screenshots
wf-recorder -> record video 
gvfs-mtp -> support for mtp devices
wl-clipboard -> clipboard for wayland
jq -> needed for parsing the swaymsg json
bash-completion -> self explanatory
mate-calc -> self explanatory
playerctl -> media sound control
mpv -> minimal video player
sway -> window manager
swaybg -> for swaywm background
swaylock -> lock screen
noto-fonts -> fonts for general ui
noto-fonts-emoji -> google's emojis
ttf-nerd-fonts-symbols -> font glyphs
pipewire -> we need sound don't we ?
pipewire-pulse -> pulse configuration
pulsemixer -> sound control tui
zathura -> pdf reader
zathura-pdf-mupdf -> pdf plugin for zathura
libreoffice-fresh -> office suite
kitty -> GPU accelerated terminal emulator
man-db -> manual pages
man-pages -> > manual pages
htop -> system info
nvtop -> gpu info
nodejs -> web dev
npm -> web dev
neovim -> development
python-pip -> needed for nvim
ripgrep -> needed for nvim
unzip -> needed for nvim and unzip stuff
wget -> needed for nvim
tidy -> needed for nvim
tar -> needed for nvim
gzip -> needed for nvim
python-pip -> nice to have
fzf -> cool fuzzy finder
imv -> image viewer
fastfetch -> pretty system info
libva-mesa-driver -> gallium video decode driver
python-wheel -> needed for pip packages 
tokei -> count lines of code blazingly fast 
docker -> containers
docker-compose -> containers
docker-buildx -> container builds for rider
kanshi -> display profiles
fuse2 -> appimage support
p7zip -> extract 7zip
unrar -> extract rar
flatpak -> sandboxed applications
gtk-engine-murrine -> theme
dunst -> notifications
polkit-gnome -> polkit
fakeroot -> aur
make -> aur
gcc -> treesitter
which -> find path of a program
android-tools -> useful
tlp -> power management
remmina -> remote desktop
freerdp -> rdp support
zip -> zip stuff
go -> golang
waybar -> statusbar
wofi -> launcher
postman-bin -> api test
bind -> dns tools
linux-headers -> kernel module stuff
nvidia-open -> nvidia driver
libva-nvidia-driver -> nvidia decode
intel-media-driver -> intel decode
gnome-keyring -> keyring
seahorse -> keyring ui
nvidia-prime -> nvidia prime run
proton-vpn-gtk-app -> vpn
qemu-desktop -> virtual machine
libvirt -> virtual machine
edk2-ovmf -> virtual machine
dnsmasq -> virtual machine
virt-manager -> virtual machine ui
hwloc -> lstopo
